0100000000
0p00000000
0p00000000
02pppp3000
000000p000
000000p000
005ppp4000
0000000000
0000000000
0000000000